NO ./assets/north.xpm42
SO ./assets/south.xpm42
EA ./assets/east.xpm42
WE ./assets/west.xpm42

F 50,50,50
C 0,0,139

1111111111111111
100D0D0000000D01
11111010D0110101
10D0D0D0D0110101
10D01111101D0D01
10D0101010110D01
10D0D0D0D0DD0D01
11111110111110D01
1000W000D0D0D0D01
1111111111111111