NO ./assets/north.xpm42
SO ./assets/south.xpm42
EA ./assets/east.xpm42
WE ./assets/west.xpm42

F 120,10,0
C 0,0,139

11111111111111111111111111111111
10000000000000000000000000000001
10000000000000000000000000000001
10000000000000000000000000000001
10000000000000000000000000000001
10000000000000000000000000000001
10000000000000000000000000000001
10000000000000000000000000000001
10000000000000000000000000000001
10000000000011000111111111111111
1000000000001000000D000D000D0001
1000000000001000000D000D000D00W1
1000000000001000000D000D000D0001
11111111111111111111111111111111